[
"##########",
"#         ",
"#         ",
"#         ",
"#         ",
"#         ",
"#         ",
"#         ",
"#         ",
"##########",
]

[
"##########",
"    #     ",
"    #     ",
"          ",
"    #    #",
"    #     ",
"    #     ",
"        ##",
"    #     ",
" ## ######",
]

[
"##########",
"          ",
"          ",
"          ",
"          ",
"        ##",
"    ##   #",
"###       ",
"         #",
"###  ### #",
]

[
"##########",
"          ",
"          ",
"          ",
"          ",
"#### #####",
"          ",
"          ",
"          ",
"##  ## # #",
]

[
"##########",
"          ",
"          ",
"####      ",
"          ",
"       ###",
"          ",
"    ###   ",
"          ",
"####   ###",
]

[
"##########",
"          ",
"          ",
"          ",
"          ",
"      ####",
"####      ",
"         #",
"          ",
"#####   ##",
]

[
"##########",
"          ",
"          ",
"          ",
"          ",
"          ",
"          ",
"          ",
"          ",
"##########",
]

[
"##########",
"          ",
"          ",
"          ",
"          ",
"          ",
"          ",
"          ",
"          ",
"##########",
]